{
 "layers":[
        {
         "data":[16, 16, 16, 16, 16, 16, 56, 56, 56, 56, 56, 56, 56, 56, 56, 56, 56, 56, 56, 56, 56, 56, 56, 56, 56, 56, 56, 56, 56, 56, 56, 56, 154, 154, 154, 154, 154, 56, 56, 16, 16, 16, 16, 56, 56, 56, 56, 56, 56, 56, 56, 56, 56, 56, 56, 56, 56, 56, 56, 56,
         16, 16, 16, 16, 16, 16, 16, 56, 56, 56, 56, 56, 56, 56, 56, 56, 56, 56, 56, 56, 56, 56, 56, 56, 56, 56, 56, 56, 56, 56, 56, 56, 154, 154, 154, 154, 154, 56, 16, 16, 16, 16, 16, 56, 56, 56, 56, 56, 56, 56, 56, 56, 56, 56, 56, 56, 56, 56, 56, 56,
         16, 16, 16, 16, 16, 16, 16, 56, 56, 56, 56, 56, 56, 56, 56, 56, 56, 56, 56, 56, 56, 56, 56, 56, 56, 56, 56, 56, 56, 56, 56, 56, 154, 154, 154, 154, 154, 56, 16, 16, 16, 16, 16, 56, 56, 56, 56, 56, 56, 56, 56, 56, 56, 56, 56, 56, 56, 56, 56, 56,
         16, 16, 16, 16, 16, 16, 16, 16, 56, 56, 56, 56, 56, 56, 56, 56, 56, 56, 56, 56, 56, 56, 56, 56, 56, 56, 56, 56, 56, 56, 56, 56, 154, 154, 154, 154, 154, 56, 16, 16, 16, 16, 16, 56, 56, 56, 56, 56, 56, 56, 56, 56, 56, 56, 56, 56, 56, 56, 56, 56,
         16, 16, 16, 16, 16, 16, 16, 16, 56, 56, 56, 56, 56, 56, 56, 56, 56, 56, 56, 56, 56, 56, 56, 56, 56, 56, 56, 56, 56, 56, 56, 56, 56, 154, 154, 154, 154, 154, 56, 16, 16, 16, 16, 56, 56, 56, 56, 56, 56, 56, 56, 56, 56, 56, 56, 56, 56, 56, 56, 56,
         56, 16, 16, 16, 16, 16, 16, 16, 56, 56, 56, 56, 56, 56, 56, 56, 56, 56, 56, 56, 56, 56, 56, 56, 56, 56, 56, 56, 56, 56, 56, 56, 56, 56, 154, 154, 154, 154, 56, 56, 56, 56, 16, 56, 56, 56, 56, 56, 56, 56, 56, 56, 56, 56, 56, 56, 56, 56, 56, 56,
         56, 56, 16, 16, 16, 16, 16, 16, 16, 16, 56, 56, 56, 56, 56, 56, 56, 56, 56, 56, 56, 56, 56, 56, 56, 56, 56, 56, 56, 56, 56, 56, 56, 56, 56, 154, 154, 154, 154, 56, 56, 56, 56, 56, 56, 56, 56, 56, 56, 56, 56, 56, 56, 56, 56, 56, 56, 56, 56, 56,
         56, 56, 56, 56, 16, 16, 16, 16, 56, 56, 56, 56, 56, 56, 56, 56, 56, 56, 56, 56, 56, 56, 56, 56, 56, 56, 56, 56, 56, 56, 56, 56, 56, 56, 154, 154, 154, 154, 154, 56, 56, 56, 56, 56, 56, 56, 56, 56, 56, 56, 56, 56, 56, 56, 56, 56, 56, 56, 56, 56,
         56, 56, 56, 56, 56, 56, 16, 16, 56, 56, 56, 56, 56, 56, 56, 56, 56, 56, 56, 56, 56, 56, 56, 56, 56, 56, 56, 56, 56, 56, 56, 56, 154, 154, 154, 154, 154, 154, 154, 56, 56, 56, 56, 56, 56, 56, 56, 56, 56, 56, 56, 56, 56, 56, 56, 56, 56, 56, 56, 56,
         56, 56, 56, 56, 56, 56, 56, 56, 56, 56, 56, 56, 56, 56, 56, 56, 56, 56, 56, 56, 56, 56, 56, 56, 56, 56, 56, 56, 56, 154, 154, 154, 154, 154, 154, 154, 154, 154, 154, 154, 56, 56, 56, 56, 56, 56, 56, 56, 56, 56, 56, 56, 56, 56, 56, 56, 56, 56, 56, 56,
         56, 56, 56, 56, 56, 56, 56, 56, 56, 56, 56, 56, 56, 56, 56, 56, 56, 56, 56, 56, 56, 56, 56, 56, 56, 56, 56, 56, 154, 154, 154, 154, 154, 154, 154, 154, 154, 154, 154, 56, 56, 56, 56, 56, 56, 56, 56, 56, 56, 56, 56, 56, 56, 56, 56, 56, 56, 56, 56, 56,
         56, 56, 56, 56, 56, 56, 56, 56, 56, 56, 56, 56, 56, 56, 56, 56, 56, 56, 56, 56, 56, 56, 56, 56, 56, 56, 154, 154, 154, 154, 154, 154, 16, 16, 16, 56, 154, 154, 154, 154, 154, 56, 56, 56, 56, 56, 56, 56, 56, 56, 56, 56, 56, 56, 56, 56, 56, 56, 56, 56,
         56, 56, 56, 56, 56, 56, 56, 56, 56, 56, 56, 56, 56, 56, 56, 16, 16, 56, 56, 56, 56, 56, 56, 56, 56, 154, 154, 154, 154, 154, 56, 56, 16, 16, 56, 56, 154, 154, 154, 154, 154, 56, 56, 56, 56, 56, 56, 56, 56, 56, 56, 56, 56, 56, 56, 56, 56, 56, 56, 56,
         56, 56, 56, 56, 56, 56, 56, 56, 56, 56, 56, 56, 56, 56, 16, 16, 16, 16, 16, 16, 56, 56, 56, 56, 154, 154, 154, 154, 154, 56, 56, 56, 56, 56, 56, 154, 154, 154, 154, 154, 154, 56, 56, 56, 56, 56, 56, 56, 56, 56, 56, 56, 56, 56, 56, 56, 56, 56, 56, 56,
         56, 56, 56, 56, 56, 56, 56, 56, 56, 56, 56, 56, 56, 16, 16, 16, 16, 16, 16, 16, 56, 56, 56, 154, 154, 154, 56, 56, 56, 56, 56, 56, 56, 56, 56, 154, 154, 154, 154, 56, 56, 56, 56, 56, 56, 56, 56, 56, 56, 56, 56, 56, 56, 56, 56, 56, 56, 56, 56, 56,
         56, 56, 56, 56, 56, 56, 56, 56, 56, 56, 56, 56, 56, 16, 16, 16, 16, 16, 16, 16, 56, 154, 154, 154, 154, 154, 56, 56, 56, 56, 56, 56, 56, 56, 154, 154, 154, 154, 56, 56, 56, 56, 56, 56, 56, 56, 56, 56, 56, 56, 56, 56, 56, 56, 56, 56, 56, 56, 56, 56,
         56, 56, 56, 56, 56, 56, 56, 56, 56, 16, 56, 56, 56, 16, 16, 16, 16, 56, 56, 56, 154, 154, 154, 154, 154, 56, 16, 16, 56, 56, 56, 56, 56, 154, 154, 154, 154, 56, 56, 56, 56, 56, 56, 56, 56, 56, 56, 56, 56, 56, 56, 56, 56, 56, 56, 56, 56, 56, 56, 56,
         56, 56, 56, 56, 56, 56, 56, 56, 56, 16, 16, 56, 56, 56, 16, 16, 56, 56, 56, 154, 154, 154, 154, 56, 56, 56, 16, 16, 16, 56, 56, 56, 154, 154, 154, 154, 56, 56, 56, 56, 56, 56, 56, 56, 16, 16, 56, 56, 56, 56, 56, 56, 56, 56, 56, 56, 56, 56, 56, 56,
         56, 56, 56, 56, 56, 56, 56, 56, 56, 16, 16, 16, 56, 16, 16, 56, 56, 56, 56, 154, 154, 154, 56, 56, 16, 16, 16, 16, 16, 16, 56, 56, 154, 154, 154, 154, 56, 56, 56, 56, 56, 56, 56, 16, 16, 16, 16, 56, 56, 56, 56, 56, 56, 56, 56, 56, 56, 56, 56, 56,
         56, 56, 56, 56, 56, 56, 56, 56, 56, 16, 16, 16, 16, 16, 16, 56, 56, 56, 154, 154, 154, 56, 16, 16, 16, 16, 16, 16, 16, 16, 56, 56, 154, 154, 154, 154, 56, 56, 56, 56, 56, 56, 16, 16, 16, 16, 16, 16, 16, 56, 56, 56, 56, 56, 56, 56, 56, 56, 56, 56,
         56, 56, 56, 56, 56, 56, 56, 56, 56, 16, 16, 16, 16, 56, 56, 56, 56, 154, 154, 154, 56, 56, 16, 16, 16, 16, 16, 16, 16, 56, 56, 154, 154, 154, 154, 56, 56, 56, 56, 56, 56, 56, 16, 16, 16, 16, 16, 16, 16, 16, 56, 56, 56, 56, 56, 56, 56, 56, 56, 56,
         56, 56, 56, 56, 56, 56, 56, 56, 56, 16, 16, 16, 16, 56, 56, 154, 154, 154, 154, 154, 56, 56, 16, 16, 56, 56, 16, 16, 56, 56, 154, 154, 154, 56, 56, 56, 56, 56, 56, 56, 56, 56, 56, 16, 16, 16, 16, 16, 16, 56, 56, 56, 56, 56, 56, 56, 56, 56, 56, 56,
         56, 56, 56, 56, 56, 56, 56, 56, 56, 56, 16, 16, 56, 56, 56, 154, 154, 154, 154, 56, 16, 16, 16, 16, 56, 56, 56, 56, 56, 56, 154, 154, 154, 56, 56, 56, 56, 56, 56, 56, 56, 56, 56, 56, 16, 16, 16, 16, 56, 56, 56, 56, 56, 56, 56, 56, 56, 56, 56, 56,
         56, 56, 56, 56, 56, 56, 56, 56, 56, 56, 56, 56, 154, 154, 154, 154, 154, 56, 56, 56, 16, 16, 16, 16, 16, 56, 56, 56, 56, 56, 154, 154, 154, 154, 56, 56, 56, 56, 56, 56, 56, 56, 56, 16, 16, 16, 16, 16, 16, 56, 56, 56, 56, 56, 56, 56, 56, 56, 56, 56,
         56, 56, 56, 56, 56, 56, 56, 56, 56, 56, 56, 56, 154, 154, 154, 154, 56, 56, 56, 16, 16, 16, 16, 16, 16, 56, 56, 56, 56, 154, 154, 154, 154, 154, 56, 56, 56, 56, 56, 56, 56, 56, 56, 16, 16, 16, 16, 16, 16, 16, 56, 56, 56, 56, 56, 56, 56, 56, 56, 56,
         56, 56, 56, 56, 56, 56, 56, 56, 56, 56, 56, 56, 154, 154, 154, 154, 56, 56, 16, 16, 16, 16, 16, 16, 16, 56, 56, 56, 56, 154, 154, 154, 56, 56, 56, 56, 56, 56, 56, 56, 56, 56, 56, 16, 16, 16, 16, 16, 16, 16, 16, 56, 56, 56, 56, 56, 56, 56, 56, 56,
         56, 56, 56, 56, 56, 56, 56, 56, 56, 154, 154, 154, 154, 154, 154, 154, 16, 16, 16, 16, 16, 16, 16, 16, 56, 56, 56, 56, 56, 154, 154, 154, 56, 56, 56, 56, 56, 56, 56, 56, 56, 56, 56, 16, 16, 16, 16, 16, 16, 16, 16, 16, 16, 56, 56, 56, 56, 56, 56, 56,
         56, 56, 56, 56, 56, 56, 56, 56, 154, 154, 154, 154, 154, 154, 154, 16, 16, 16, 16, 16, 16, 16, 16, 16, 56, 56, 154, 154, 154, 154, 154, 154, 154, 56, 56, 56, 56, 56, 56, 56, 56, 56, 56, 56, 16, 16, 16, 16, 16, 16, 16, 16, 16, 56, 56, 56, 56, 56, 56, 56,
         56, 56, 56, 154, 154, 154, 154, 154, 154, 154, 154, 154, 154, 154, 56, 16, 16, 16, 16, 16, 16, 16, 16, 16, 56, 56, 154, 154, 154, 154, 154, 154, 154, 154, 56, 56, 56, 56, 56, 56, 56, 56, 56, 16, 16, 16, 16, 16, 16, 16, 16, 16, 56, 56, 56, 56, 56, 56, 56, 56,
         154, 154, 154, 154, 154, 154, 154, 154, 154, 154, 56, 56, 16, 16, 16, 16, 16, 16, 56, 56, 56, 16, 16, 16, 56, 56, 154, 154, 154, 56, 56, 154, 154, 154, 154, 154, 56, 56, 16, 16, 16, 16, 16, 16, 16, 16, 16, 16, 16, 16, 16, 56, 56, 56, 56, 56, 56, 56, 56, 56,
         154, 154, 154, 154, 56, 56, 56, 56, 56, 56, 56, 56, 16, 16, 16, 16, 16, 56, 56, 56, 56, 16, 16, 16, 56, 56, 154, 154, 154, 56, 56, 56, 56, 154, 154, 154, 154, 16, 16, 16, 16, 16, 16, 16, 16, 16, 16, 16, 16, 16, 16, 56, 56, 56, 56, 56, 56, 56, 56, 56,
         154, 154, 154, 56, 56, 56, 56, 56, 56, 56, 56, 56, 16, 16, 16, 16, 56, 56, 56, 56, 56, 16, 16, 16, 56, 56, 154, 154, 154, 56, 56, 56, 56, 56, 154, 154, 154, 154, 154, 16, 16, 16, 16, 16, 16, 16, 16, 16, 16, 16, 16, 56, 56, 56, 56, 56, 56, 56, 56, 56,
         154, 56, 56, 56, 56, 56, 56, 56, 56, 56, 56, 56, 56, 56, 56, 56, 56, 56, 56, 56, 56, 56, 56, 56, 56, 56, 56, 56, 154, 56, 56, 56, 56, 56, 56, 56, 154, 154, 154, 154, 16, 16, 16, 16, 16, 16, 16, 16, 16, 16, 16, 56, 56, 56, 56, 56, 56, 56, 56, 56,
         56, 56, 56, 56, 56, 56, 56, 56, 56, 56, 56, 56, 56, 56, 56, 56, 56, 56, 56, 56, 56, 56, 56, 56, 56, 56, 56, 56, 154, 154, 154, 56, 56, 56, 56, 56, 56, 154, 154, 154, 154, 16, 16, 16, 16, 16, 16, 16, 16, 16, 56, 56, 56, 56, 56, 56, 56, 56, 56, 56,
         56, 56, 56, 56, 56, 56, 56, 56, 56, 56, 56, 56, 56, 56, 56, 56, 56, 56, 56, 56, 56, 56, 56, 56, 56, 56, 56, 56, 154, 154, 154, 56, 56, 56, 56, 56, 56, 154, 154, 154, 154, 154, 16, 16, 16, 16, 16, 16, 16, 56, 56, 56, 56, 56, 56, 56, 56, 56, 56, 56,
         56, 56, 56, 56, 56, 56, 56, 56, 56, 56, 56, 56, 56, 56, 56, 56, 56, 56, 56, 56, 56, 56, 56, 56, 56, 56, 56, 56, 56, 154, 154, 154, 56, 56, 56, 56, 56, 56, 154, 154, 154, 154, 154, 154, 16, 16, 16, 16, 56, 56, 56, 56, 56, 56, 56, 56, 56, 56, 56, 56,
         56, 56, 56, 56, 56, 56, 56, 56, 56, 56, 56, 56, 56, 56, 56, 56, 56, 56, 56, 56, 56, 56, 56, 56, 56, 56, 56, 56, 56, 154, 154, 154, 154, 56, 56, 56, 56, 56, 56, 154, 154, 154, 154, 154, 154, 154, 16, 16, 16, 56, 56, 56, 56, 56, 56, 56, 56, 56, 56, 56,
         56, 56, 56, 56, 56, 56, 56, 56, 56, 56, 56, 56, 56, 56, 56, 56, 56, 56, 56, 56, 56, 56, 56, 56, 56, 56, 56, 56, 56, 154, 154, 154, 154, 56, 56, 16, 16, 16, 56, 56, 56, 154, 154, 154, 154, 154, 16, 16, 16, 16, 56, 56, 56, 56, 56, 56, 56, 56, 56, 56,
         56, 56, 56, 56, 56, 56, 56, 56, 56, 56, 56, 56, 56, 56, 56, 56, 56, 56, 56, 56, 56, 56, 56, 56, 56, 56, 56, 56, 56, 154, 154, 154, 56, 56, 56, 16, 16, 16, 56, 56, 56, 56, 154, 154, 154, 154, 16, 16, 16, 16, 56, 56, 56, 56, 56, 56, 56, 56, 56, 56,
         56, 56, 56, 56, 56, 56, 56, 56, 56, 56, 56, 56, 56, 56, 56, 56, 56, 56, 56, 56, 56, 56, 56, 56, 56, 56, 56, 56, 56, 154, 154, 154, 56, 56, 56, 16, 16, 16, 16, 56, 56, 56, 56, 154, 154, 154, 154, 16, 16, 16, 16, 56, 56, 56, 56, 56, 56, 56, 56, 56,
         56, 56, 56, 56, 56, 56, 56, 56, 56, 56, 56, 56, 56, 56, 56, 56, 56, 56, 56, 56, 56, 56, 56, 56, 56, 56, 56, 56, 56, 154, 154, 154, 154, 56, 56, 16, 16, 16, 16, 16, 56, 56, 56, 56, 154, 154, 154, 154, 154, 16, 16, 56, 56, 56, 56, 56, 56, 56, 56, 56,
         56, 56, 56, 56, 56, 56, 56, 56, 56, 56, 56, 56, 56, 56, 56, 56, 56, 56, 56, 56, 56, 56, 56, 56, 56, 56, 56, 56, 56, 154, 154, 154, 154, 56, 56, 16, 16, 16, 16, 16, 16, 56, 56, 56, 56, 56, 154, 154, 154, 154, 16, 16, 56, 56, 56, 56, 56, 56, 56, 56,
         56, 56, 56, 56, 56, 56, 56, 56, 56, 56, 56, 56, 56, 56, 56, 56, 56, 56, 56, 56, 56, 56, 56, 56, 56, 56, 56, 56, 56, 154, 154, 154, 154, 56, 56, 16, 16, 16, 16, 16, 16, 16, 56, 56, 56, 56, 154, 154, 154, 154, 154, 16, 16, 16, 16, 16, 16, 16, 16, 16,
         56, 56, 56, 56, 56, 56, 56, 56, 56, 56, 56, 56, 56, 56, 56, 56, 56, 56, 56, 56, 56, 56, 56, 56, 56, 56, 56, 56, 154, 154, 56, 56, 56, 16, 16, 16, 16, 16, 16, 16, 16, 16, 56, 56, 56, 56, 56, 154, 154, 154, 154, 154, 154, 16, 16, 16, 16, 16, 16, 16,
         56, 56, 56, 56, 56, 56, 56, 56, 56, 56, 56, 56, 56, 56, 56, 56, 56, 56, 56, 56, 56, 56, 56, 56, 56, 56, 56, 154, 154, 154, 56, 56, 56, 16, 16, 16, 16, 16, 16, 16, 16, 16, 56, 56, 56, 56, 56, 56, 154, 154, 154, 154, 154, 154, 16, 16, 16, 16, 16, 154,
         56, 56, 56, 56, 56, 56, 56, 56, 56, 56, 56, 56, 56, 56, 56, 56, 56, 56, 56, 56, 56, 56, 56, 56, 56, 56, 154, 154, 154, 154, 56, 56, 56, 56, 56, 56, 56, 56, 56, 56, 16, 16, 16, 56, 56, 56, 56, 56, 56, 56, 154, 154, 154, 154, 154, 16, 16, 16, 154, 154,
         56, 56, 56, 56, 56, 56, 56, 56, 56, 56, 56, 56, 56, 56, 56, 56, 56, 56, 56, 56, 56, 56, 56, 56, 56, 56, 154, 154, 154, 154, 56, 56, 56, 56, 56, 56, 56, 56, 56, 56, 56, 56, 56, 56, 56, 56, 56, 56, 56, 56, 56, 154, 154, 154, 154, 154, 154, 154, 154, 154,
         56, 56, 56, 56, 56, 56, 56, 56, 56, 56, 56, 56, 56, 56, 56, 56, 56, 56, 56, 56, 56, 56, 56, 56, 56, 56, 154, 154, 154, 56, 56, 56, 56, 56, 56, 56, 56, 56, 56, 56, 56, 56, 56, 56, 56, 56, 56, 56, 56, 56, 56, 56, 154, 154, 154, 154, 154, 154, 154, 154,
         56, 56, 56, 56, 56, 56, 56, 56, 56, 56, 56, 56, 56, 56, 56, 56, 56, 56, 56, 56, 56, 56, 56, 56, 56, 56, 154, 154, 154, 16, 16, 56, 56, 56, 56, 56, 56, 56, 56, 56, 56, 56, 56, 56, 56, 56, 56, 56, 56, 56, 56, 56, 56, 16, 154, 154, 154, 154, 154, 154,
         56, 56, 56, 56, 56, 56, 56, 56, 56, 56, 56, 56, 56, 56, 56, 56, 56, 56, 56, 56, 56, 56, 56, 56, 56, 56, 154, 154, 154, 16, 16, 16, 56, 56, 56, 56, 56, 56, 56, 56, 56, 56, 56, 56, 56, 56, 56, 56, 56, 56, 56, 56, 16, 16, 16, 154, 154, 154, 154, 154,
         56, 56, 56, 56, 56, 56, 56, 56, 56, 56, 56, 56, 56, 56, 56, 56, 56, 56, 56, 56, 56, 56, 56, 56, 56, 56, 154, 154, 154, 16, 16, 16, 16, 56, 56, 56, 56, 56, 56, 56, 56, 56, 56, 56, 56, 56, 56, 56, 56, 56, 56, 56, 16, 16, 16, 16, 154, 154, 154, 154,
         56, 56, 56, 56, 56, 56, 56, 56, 56, 56, 56, 56, 56, 56, 56, 56, 56, 56, 56, 56, 56, 56, 56, 56, 56, 56, 56, 154, 154, 154, 16, 16, 16, 16, 56, 56, 56, 56, 56, 56, 56, 56, 56, 56, 56, 56, 56, 56, 56, 56, 56, 56, 16, 16, 16, 16, 16, 154, 154, 154,
         56, 56, 56, 56, 56, 56, 56, 56, 56, 56, 56, 56, 56, 56, 56, 56, 56, 56, 56, 56, 56, 56, 56, 56, 56, 56, 56, 154, 154, 154, 16, 16, 16, 16, 56, 56, 56, 56, 56, 56, 56, 56, 56, 56, 56, 56, 56, 56, 56, 56, 56, 16, 16, 16, 16, 16, 16, 154, 154, 154,
         56, 56, 56, 56, 56, 56, 56, 56, 56, 56, 56, 56, 56, 56, 56, 56, 56, 56, 56, 56, 56, 56, 56, 56, 56, 56, 56, 154, 154, 154, 16, 16, 16, 16, 16, 56, 56, 56, 56, 56, 56, 56, 56, 56, 56, 56, 56, 56, 56, 56, 56, 16, 16, 16, 16, 16, 16, 16, 154, 154,
         56, 56, 56, 56, 56, 56, 56, 56, 56, 56, 56, 56, 56, 56, 56, 56, 56, 56, 56, 56, 56, 56, 56, 56, 56, 56, 56, 154, 154, 154, 56, 16, 16, 16, 16, 56, 56, 56, 56, 56, 56, 56, 56, 56, 56, 56, 56, 56, 56, 56, 56, 16, 16, 16, 16, 16, 16, 16, 16, 154,
         56, 56, 56, 56, 56, 56, 56, 56, 56, 56, 56, 56, 56, 56, 56, 56, 56, 56, 56, 56, 56, 56, 56, 56, 56, 56, 56, 154, 154, 154, 56, 56, 56, 56, 56, 56, 56, 56, 56, 56, 56, 56, 56, 56, 56, 56, 56, 56, 56, 56, 56, 16, 16, 16, 16, 16, 16, 16, 16, 154,
         56, 56, 56, 56, 56, 56, 56, 56, 56, 56, 56, 56, 56, 56, 56, 56, 56, 56, 56, 56, 56, 56, 56, 56, 56, 56, 56, 154, 154, 154, 56, 56, 56, 56, 56, 56, 56, 56, 56, 56, 56, 56, 56, 56, 56, 56, 56, 56, 56, 56, 16, 16, 16, 16, 16, 16, 16, 16, 16, 16,
         56, 56, 56, 56, 56, 56, 56, 56, 56, 56, 56, 56, 56, 56, 56, 56, 56, 56, 56, 56, 56, 56, 56, 56, 56, 56, 56, 154, 154, 154, 56, 56, 56, 56, 56, 56, 56, 56, 56, 56, 56, 56, 56, 56, 56, 56, 56, 56, 56, 56, 16, 16, 16, 16, 16, 16, 16, 16, 16, 16,
         56, 56, 56, 56, 56, 56, 56, 56, 56, 56, 56, 56, 56, 56, 56, 56, 56, 56, 56, 56, 56, 56, 56, 56, 56, 56, 56, 154, 154, 56, 56, 56, 56, 56, 56, 56, 56, 56, 56, 56, 56, 56, 56, 56, 56, 56, 56, 56, 56, 56, 56, 56, 16, 16, 16, 16, 16, 16, 16, 16,
         56, 56, 56, 56, 56, 56, 56, 56, 56, 56, 56, 56, 56, 56, 56, 56, 56, 56, 56, 56, 56, 56, 56, 56, 56, 56, 56, 154, 154, 56, 56, 56, 56, 56, 56, 56, 56, 56, 56, 56, 56, 56, 56, 56, 56, 56, 56, 56, 56, 56, 56, 56, 56, 16, 16, 16, 16, 16, 16, 16],
         "height":60,
         "width":60,
         "tileClass": {
              "16":"dirt",
              "56":"grass",
              "154":"water"
         }
        }
       ],
 "orientation":"orthogonal",
 "renderorder":"right-down",
 "tileheight":32,
 "tilewidth":32,
 "type":"map",
 "width":60,
 "height":60
}